*************
*          G*
* ***********
* ***********
* ********* *
* ********* *
* ********* *
* ********* *
*     S     *
*************