**********************
*S          ********G*
* ********* ******** *
* ********* ******** *
*        ** ******** *
* ********* ******** *
* ********* ******** *
* ********* ******** *
* ********* ******** *
* ********* ******** *
* ********* ******** *
* ********* ******** *
* ********* ******** *
* ********* ******** *
* ********* ******** *
* ********* ******** *
* ********* ******** *
* ********* ******** *
* ********* ******** *
* ****************** *
*                    *
**********************