***************
***************
* ****        *
* **** ****** *
* **** ****** *
* **** ****** *
* **** ****** *
* **** ********
*     S     *G*
* **** ********
* **** ****** *
* **** ****** *
* **** ****** *
* **** ****** *
* ****        *
***************
***************